XXXXXXXXXXXXXX
X            X
X XXX X   XX X
X     XX   X X
X         X  X
X    X  X    X
X X   X X XXXX
X X  X  X   XX
X XX   XXX   X
X    X       X
XXXXXXXXXXXXXX